#####################################################
#....<..............................................#
#.....................................###...........#
#...........>..........................#............#
#......................................#............#
#......................................#............#
#.....................................###...........#
#####################################################